XXXXXXXXXXXXXXXXXXXXXXXXXXXXXX
X                             
X X X X X X X X X X X X X X X 
X                             
X X X X X X X X X X X X X X X 
X                             
X X X X X X X X X X X X X X X 
X                             
X X X X X X X X X X X X X X X 
X                             
X X X X X X X X X X X X X X X 
X                            E
X X X X X X X X X X X X X X Xo
X                            o
X X X X X X X     X X X X X Xo
X              Soooooooooooooo
X X X X X X X  o  X X X X X X 
X              o              
X X X X X X X XoX X X X X X X 
X              o              
X X X X X X X XoX X X X X X X 
X              o              
X X X X X X X XoX X X X X X X 
X              o              
X X X X X X X XoX X X X X X X 
X              o              
X X X X X X X XoX X X X X X X 
X              o              
X X X X X X X XoX X X X X X X 
X EoooooooooEooo              
