XXXXXXXXX
        E
XX X X X 
         
XX  SooX 
      o  
XX X XoX 
      o  
XEXXXXEXX
